NO ./path_to_the_north_texture
SO ./path_to_the_south_texture
WE ./path_to_the_west_texture
EA ./path_to_the_east_texture
F 00,100,0
C 225,0,0
        1111111111111111111111111
        1000000000110000000000001
        1011000001110000000000001
        1001000000000000000000001
111111111011000001110000000000001
100000000001000001110111111111111
11110111110111011100000010001
11110111110111011101010000001
11000001110111011100000010001
1000000100W010001100000101001
10000001111110001101010010001
110000011101010111110111000111
11110111 1110101 101111010001
11111111 1111111 111111111111
      