NO ./textures/nord.png
SO ./textures/south.png
WE ./textures/west.png
EA ./textures/ss.png
F 255,100,255
C 0,255,255
        1111111111111111111111111
        1000000000110000000000001
        1011000001110000000000001
        10010000W0000000000000001
111111111011000001110000000000001
100000000001000001110111111111111
11110111110111011100000010001
11110111110111011101010000001
11000001110111011100000010001
10000001000010001100000101001
10000001111110001101010010001
110000011101010111110111000111
11110111 1110101 101111010001
11111111 1111111 111111111111
      