
EA ./mandatory/textures/east.png
NO ./mandatory/textures/nord.png
SO ./mandatory/textures/south.png


WE ./mandatory/textures/west.png




C 176,226,254

F 144,238,144




1111111111111111111111111   1111
1000000000110000000000001   1011
1011000001110000000000001   1111
1001000000000000000000001111111111111
1111111111111011000001110000000000001
1000000000110000011101111111111111111
11110111111111011100000010001
11110111111111011101010010001
11000000110101011100000010001
10000000000000001100000010001
10000000000000001101010000001
11000001110101011111011110N0111
11110111 1110101 1011110100011
11111111 1111111 111111111111
       